10 10
0 0 5 0 0 0 0 0 0 0 
0 3 3 3 0 0 5 0 0 0 
5 3 3 3 3 3 3 3 0 0 
0 0 3 3 3 3 3 3 0 5 
0 0 3 3 3 3 3 3 3 0 
5 3 3 3 3 3 3 3 3 5 
5 5 3 3 3 3 3 3 3 3 
5 5 3 3 3 3 3 3 3 5 
5 5 5 5 3 3 3 3 3 3 
5 5 5 5 5 5 3 3 3 3 
